6
6
WWWWWW
S W  W
W W WW
W    W
WW W W
WWWWEW